tilesetIso.png 7 57 798
15 15
1 1 2 4 1 3 0 1 1 1 2 1 3 1 1
4 4 1 4 1 2 1 3 1 2 1 1 1 3 1
1 1 0 1 4 1 2 4 1 3 4 2 1 0 1
3 1 4 1 1 1 0 1 3 4 1 4 1 1 1
1 2 1 3 1 4 2 1 2 1 0 1 2 1 0
0 1 3 1 0 1 1 3 1 4 1 2 1 1 1
1 0 1 4 2 1 1 1 0 1 3 1 4 1 2
4 1 4 1 2 0 1 5 1 1 4 1 0 1 3
1 2 1 1 1 2 1 3 1 1 1 2 1 1 0
1 1 3 4 1 0 1 2 1 1 1 0 1 3 1
0 1 1 1 1 1 1 3 1 4 2 1 4 1 0
1 2 1 0 1 2 1 1 1 1 3 1 1 1 1
1 3 1 1 3 1 4 1 0 1 2 0 1 2 4
0 1 4 1 2 1 1 3 1 1 1 1 3 1 0
6 1 2 1 3 1 0 1 1 1 1 1 4 1 1
